#;#;#;#;#;#;#;#;#;#;#;#;#;#;#;#;#;#;#;#;#;#;#;#;#;#;#;#;#;#;#;#;#;#;#;#;#;#;#;#;#;#;#;#;#;#;#;#;#;#;#;#;#;#;#;#;#;#;#;#;#;#;#;#;#;#;#;#;#;#;#;#;#;#;#;#;#;#;#;#
#;.;.;#;.;.;.;.;.;.;.;.;#;.;#;.;.;.;.;.;#;.;.;.;#;.;.;.;.;.;.;.;#;.;.;.;.;.;.;.;.;.;.;.;#;.;.;.;.;.;.;.;.;#;.;.;.;.;.;.;.;.;.;.;.;.;.;.;#;.;.;.;.;.;.;.;.;.;.;#
#;#;.;#;.;#;#;.;#;#;#;.;#;.;#;#;#;.;#;.;#;.;#;.;#;.;#;.;#;.;#;.;#;.;#;#;#;.;#;.;#;.;#;.;.;.;#;.;#;#;#;#;.;#;#;#;#;#;#;.;#;#;#;#;#;#;#;.;#;.;#;#;#;#;.;#;#;#;.;#
#;.;.;#;.;#;.;.;.;.;#;.;#;.;.;.;#;.;#;.;#;.;#;.;#;.;#;.;#;.;#;.;#;.;#;.;#;#;#;.;#;#;#;#;#;#;#;.;.;.;.;#;.;#;.;.;.;.;.;.;#;.;.;.;.;.;.;.;.;.;#;.;.;.;.;.;.;#;.;#
#;.;.;.;.;#;#;.;#;.;#;.;#;.;#;#;#;.;#;.;#;.;#;.;.;.;#;.;#;.;#;.;.;.;#;.;.;.;.;.;.;.;.;.;.;.;#;#;#;#;#;#;.;#;#;#;#;.;#;#;#;#;#;#;#;.;#;.;#;#;#;#;#;.;#;.;.;#;.;#
#;.;#;.;.;#;.;.;#;.;#;.;#;.;.;.;.;.;#;.;#;.;#;#;#;#;#;.;#;.;#;#;.;#;#;#;#;#;#;.;#;#;#;#;#;.;.;.;.;.;.;.;.;.;.;.;#;#;#;.;.;.;.;.;.;.;#;.;#;.;.;.;#;.;#;.;#;#;.;#
#;.;#;#;.;#;.;#;#;.;#;.;#;#;#;#;#;.;#;#;#;.;#;.;.;.;.;.;#;.;#;.;.;.;#;.;.;.;.;.;#;.;.;.;.;.;#;#;#;#;#;#;#;#;#;#;#;.;.;.;#;.;#;#;#;#;#;.;#;.;#;.;.;.;#;.;.;#;.;#
#;.;.;#;.;#;.;.;#;.;#;.;.;.;.;.;.;.;.;.;.;.;#;.;#;#;#;#;#;.;#;#;#;.;#;.;#;#;#;.;#;.;#;#;#;.;#;.;.;.;.;.;.;.;.;.;#;.;#;.;#;.;.;.;.;.;#;.;#;.;.;.;#;.;#;#;.;#;.;#
#;#;#;#;#;#;#;.;#;#;#;#;#;#;#;#;#;#;#;#;#;#;#;.;#;.;.;.;.;.;.;.;#;.;#;.;#;.;#;.;#;.;#;.;#;.;#;#;.;#;.;#;#;#;#;.;#;#;#;#;#;.;#;#;#;#;#;.;#;.;#;#;#;.;#;.;.;#;.;#
#;.;.;.;.;.;#;.;#;.;.;.;.;.;.;.;.;.;.;.;.;.;#;.;#;.;#;#;#;#;#;#;#;.;#;#;#;.;#;.;#;.;#;.;.;.;#;.;.;#;.;#;.;.;.;.;#;.;.;.;#;.;#;.;.;.;.;.;#;.;#;.;.;.;#;.;#;#;.;#
#;.;#;.;#;.;#;.;#;.;#;#;#;#;#;#;#;#;#;#;#;.;#;.;.;.;#;.;.;.;.;.;.;.;.;.;.;.;.;.;#;.;#;#;#;#;#;#;#;#;.;#;.;.;#;.;.;.;#;.;#;.;#;.;#;#;#;#;#;#;#;.;#;#;#;.;#;.;.;#
#;.;#;#;#;.;#;.;#;.;.;.;.;.;.;.;.;.;.;.;#;.;#;#;#;#;#;.;#;#;#;#;#;#;#;#;#;#;#;#;#;.;.;.;.;.;.;.;.;.;.;#;.;#;#;#;#;#;#;.;#;.;#;.;.;.;.;.;.;.;#;.;#;.;#;.;#;.;#;#
#;.;.;.;#;.;.;.;#;#;#;#;#;#;#;#;.;#;#;.;#;.;#;.;.;.;.;.;#;.;.;.;#;.;#;.;.;.;.;.;#;#;#;#;.;#;.;#;#;#;.;#;.;.;.;.;#;.;#;.;#;.;#;.;#;#;#;#;#;#;#;.;#;.;.;.;.;.;.;#
#;#;#;#;#;#;#;.;.;.;#;.;.;.;.;.;.;.;#;.;#;.;#;#;#;.;#;#;#;.;#;.;.;.;.;.;#;#;#;#;#;.;.;.;.;.;.;.;#;.;.;#;.;.;#;.;.;.;#;.;#;.;#;.;#;.;#;.;.;.;#;.;#;#;#;#;#;#;.;#
#;.;.;.;.;.;#;#;#;.;#;#;#;#;#;.;#;.;#;.;#;.;#;.;.;.;.;.;#;.;#;#;#;.;#;.;.;.;#;.;#;.;#;#;#;#;.;#;#;.;#;#;.;#;#;#;#;#;#;#;#;.;#;.;#;.;.;.;#;.;.;.;.;.;.;.;.;#;.;#
#;.;#;#;#;.;.;.;.;.;.;.;.;.;#;.;#;.;#;.;#;.;#;.;#;#;#;#;#;.;#;.;#;.;#;#;#;.;#;.;#;.;.;.;.;.;.;#;.;.;.;.;.;.;#;.;.;.;.;.;.;.;#;.;#;#;#;#;#;#;#;#;#;#;#;#;#;#;#;#
#;.;#;.;#;#;#;#;#;#;#;#;#;.;#;.;#;.;#;.;#;.;.;.;.;.;.;.;#;.;#;.;.;.;#;.;.;.;#;.;#;#;.;#;#;.;#;#;#;#;#;.;#;.;#;.;#;#;#;#;#;.;#;.;.;.;.;.;.;.;#;.;.;.;.;#;.;.;.;#
#;.;#;.;.;.;#;.;.;.;#;.;#;.;#;#;#;#;#;.;#;#;#;#;#;#;#;#;#;.;#;#;#;.;#;#;#;#;#;.;.;.;.;#;.;.;.;#;.;.;.;.;#;.;#;.;#;.;.;.;#;.;#;#;#;#;.;#;#;#;#;.;#;.;#;#;.;#;.;#
#;.;.;.;#;.;.;.;#;.;.;.;#;.;.;#;.;.;.;.;#;.;.;.;.;.;.;.;.;.;.;.;.;.;.;.;.;.;.;.;#;#;#;#;#;#;#;#;#;#;#;#;#;.;#;#;#;.;#;.;.;.;.;.;#;.;.;.;.;.;.;.;#;.;.;.;.;#;.;#
#;#;#;#;#;#;#;#;#;#;#;#;#;#;.;#;#;#;.;#;#;#;#;#;#;#;#;#;#;#;#;#;#;#;#;#;#;#;#;#;#;.;.;.;.;.;.;.;.;.;.;.;.;.;.;.;#;.;#;#;#;#;#;#;#;#;#;#;#;#;.;#;#;#;#;#;#;#;.;#
#;.;.;.;.;#;.;.;.;.;.;.;.;#;.;#;.;.;.;#;.;#;.;.;.;.;.;.;.;.;.;.;.;.;.;.;.;.;.;.;#;#;#;#;.;#;#;#;#;#;#;#;#;#;#;#;#;.;#;.;#;.;.;.;.;.;.;.;.;#;.;.;.;.;.;.;.;#;.;#
#;.;#;#;.;#;#;#;.;#;#;#;#;#;.;#;.;#;#;#;.;#;.;#;#;#;#;#;#;#;#;#;#;#;#;#;#;.;#;.;#;.;#;.;.;#;.;.;.;.;.;#;.;.;.;.;.;.;#;.;#;.;#;#;#;#;#;#;.;#;#;#;#;#;#;#;#;#;.;#
#;.;#;.;.;.;.;.;.;.;.;.;.;.;.;#;.;.;.;#;.;#;.;#;.;#;.;.;.;.;.;.;.;.;.;.;.;.;#;.;#;.;.;.;.;#;#;#;#;#;.;#;#;#;#;#;#;.;#;.;#;.;#;.;#;.;.;#;.;.;.;.;.;.;.;.;.;.;.;#
#;.;#;.;#;#;#;#;#;#;#;#;#;#;.;#;#;#;.;#;.;.;.;#;.;#;#;#;#;.;#;#;#;#;#;#;#;#;#;.;#;.;#;#;#;#;.;#;.;.;.;#;.;.;.;#;.;.;#;.;#;.;.;.;#;.;#;#;#;#;#;#;#;#;.;#;#;#;.;#
#;.;#;.;.;.;#;.;.;.;.;.;.;.;.;#;.;.;.;#;.;#;#;#;.;.;.;.;#;.;#;.;.;.;.;.;#;.;#;.;.;.;.;.;#;.;.;.;.;#;.;.;.;#;.;.;.;.;.;.;#;.;#;.;#;.;#;.;.;.;.;.;.;.;.;#;.;#;.;#
#;.;.;.;#;.;#;.;#;#;#;#;#;#;.;#;.;#;.;#;.;#;.;.;.;.;#;.;#;#;#;.;#;#;#;.;#;.;#;#;#;#;#;.;#;#;#;#;#;#;#;#;#;#;#;#;#;#;#;#;#;#;#;.;#;.;.;.;#;#;#;#;.;#;.;#;.;.;.;#
#;.;#;#;#;#;#;.;#;.;#;.;.;#;#;#;#;#;.;#;#;#;.;#;#;#;#;.;.;.;.;.;.;.;#;.;#;.;.;.;.;.;#;.;.;#;.;.;.;.;.;.;.;.;.;.;.;.;.;.;.;.;.;.;#;#;#;.;#;.;.;#;.;#;.;#;.;#;.;#
#;.;#;.;.;.;#;.;#;.;#;.;.;.;.;.;#;.;.;#;.;.;.;#;.;#;#;#;#;#;#;#;#;#;#;.;#;.;#;.;#;.;#;#;.;#;.;#;#;#;#;#;#;#;#;#;#;#;#;.;#;#;#;.;.;.;#;.;#;#;.;#;.;#;.;#;.;#;.;#
#;#;#;.;#;.;#;.;#;.;#;.;#;#;#;#;#;.;#;#;.;#;.;.;.;#;.;.;#;.;.;.;.;.;#;.;#;.;#;.;#;.;#;.;.;#;.;#;.;.;.;#;.;.;.;.;.;.;.;.;#;.;#;#;#;.;#;.;.;#;.;#;.;#;.;#;.;#;.;#
#;.;.;.;#;.;.;.;#;.;.;.;.;.;.;.;.;.;.;#;.;#;.;#;.;#;#;.;#;.;#;.;#;.;#;.;#;.;#;#;#;.;#;.;#;#;.;#;.;#;.;#;.;#;.;#;#;#;#;.;#;.;#;.;#;.;#;.;#;#;.;#;.;#;#;#;.;.;.;#
#;.;#;#;#;#;#;#;#;#;#;#;#;.;#;#;#;#;#;#;.;#;.;#;.;#;.;.;#;.;#;.;#;.;#;.;#;.;.;.;#;.;#;.;#;.;.;.;.;#;.;.;.;#;.;.;.;.;#;.;#;.;.;.;.;.;#;.;.;.;.;#;.;.;.;#;.;#;#;#
#;.;.;.;.;.;.;.;#;.;.;.;.;.;#;.;.;.;.;.;.;#;#;#;.;#;.;#;#;.;#;.;#;.;#;.;#;#;#;.;#;.;#;.;#;.;#;#;.;#;.;#;#;#;#;#;#;#;#;#;#;#;#;#;.;#;#;#;#;.;#;#;#;.;#;#;.;.;.;#
#;.;#;#;#;#;#;.;#;#;#;#;#;#;#;#;.;#;#;#;#;#;.;#;.;#;.;.;#;.;#;.;#;.;#;.;.;.;#;.;#;.;#;.;#;.;#;.;.;#;.;#;.;.;.;.;.;.;.;.;.;.;.;#;.;#;.;#;.;.;.;.;.;.;.;#;#;#;.;#
#;.;#;.;.;.;.;.;.;.;.;#;.;#;.;.;.;#;.;#;.;#;.;#;.;#;#;.;#;.;#;.;#;.;#;#;#;.;#;.;#;.;#;.;#;.;#;.;#;#;.;#;.;#;#;#;#;#;#;.;#;.;#;#;.;#;.;#;#;#;.;#;#;#;#;#;.;.;.;#
#;.;#;#;#;#;#;#;.;#;.;.;.;#;.;#;.;#;.;#;.;.;.;.;.;#;.;.;#;.;#;.;#;.;.;.;#;.;#;.;#;.;#;.;#;.;#;.;.;#;.;#;.;.;#;.;.;.;#;.;#;.;.;#;.;#;.;.;.;.;.;#;.;.;.;#;.;#;#;#
#;.;#;.;#;.;.;.;.;#;#;#;#;#;.;#;.;#;.;#;#;#;#;#;.;#;.;#;#;.;#;.;#;#;#;.;.;.;#;.;#;.;#;.;#;.;#;#;#;#;#;#;.;#;#;.;#;#;#;.;#;#;.;#;.;#;#;#;#;#;#;#;.;#;.;#;.;#;.;#
#;.;#;.;.;.;#;.;.;.;.;.;.;.;.;#;.;#;.;#;.;.;.;.;.;#;.;.;#;.;#;.;.;.;#;#;#;#;#;#;#;.;.;.;#;.;.;.;.;.;.;.;.;.;.;.;#;.;.;.;#;.;.;#;.;.;.;.;#;.;.;#;.;#;.;#;.;#;.;#
#;.;#;#;#;.;#;#;#;#;#;#;#;#;#;#;#;#;.;#;.;#;#;#;#;#;#;.;#;.;#;#;#;.;.;.;.;.;.;.;#;#;#;.;#;#;#;#;#;#;#;#;#;#;#;#;#;#;#;.;#;.;#;#;.;#;#;#;#;#;.;#;#;#;.;#;.;#;.;#
#;.;.;.;.;.;.;.;.;.;.;.;.;.;.;.;.;.;.;#;.;.;.;.;.;.;.;.;#;.;.;.;#;#;#;#;#;#;$;$;$;$;#;.;.;.;.;.;.;.;.;.;.;.;.;.;.;.;.;.;#;.;.;.;.;#;.;.;.;.;.;.;.;.;.;.;.;.;.;#
#;#;#;#;#;#;#;#;#;#;#;#;#;#;#;#;#;#;#;#;#;#;#;#;#;#;#;#;#;.;#;.;.;.;.;.;.;.;.;.;2;$;#;#;#;#;#;#;#;#;#;#;#;#;#;#;#;#;#;#;#;#;#;#;#;#;#;#;#;#;#;#;#;#;#;#;#;#;#;#
#;#;#;#;#;#;#;#;#;#;#;#;#;#;#;#;#;#;#;#;#;#;#;#;#;#;#;#;#;#;#;#;#;#;#;#;#;#;$;1;.;.;.;.;.;.;.;.;.;#;.;#;#;#;#;#;#;#;#;#;#;#;#;#;#;#;#;#;#;#;#;#;#;#;#;#;#;#;#;#
#;.;.;.;.;.;.;.;.;.;.;.;.;.;#;.;.;.;.;#;.;.;.;.;.;.;.;.;.;.;.;.;.;.;.;.;.;#;$;$;$;$;#;#;#;#;#;#;.;.;.;#;.;.;.;.;.;.;.;.;#;.;.;.;.;.;.;.;.;.;.;.;.;.;.;.;.;.;.;#
#;.;#;.;#;.;#;#;#;.;#;#;#;#;#;.;#;#;.;#;.;#;#;#;#;#;#;#;#;#;#;#;#;#;#;#;.;#;#;#;.;.;.;.;.;.;.;#;#;#;.;#;.;#;#;#;#;#;#;.;#;.;#;#;#;#;#;#;#;#;#;#;#;#;.;#;#;#;.;#
#;.;#;.;#;.;#;.;#;.;.;#;.;.;.;.;#;.;.;#;.;.;.;#;.;.;.;.;.;.;.;.;.;.;.;#;.;.;.;#;#;#;#;#;#;#;.;.;.;#;.;#;.;.;#;.;.;.;.;.;#;.;#;.;#;.;.;.;.;.;.;.;.;#;.;.;.;#;.;#
#;.;#;.;#;.;#;.;#;#;#;#;#;#;#;.;#;.;#;#;.;#;#;#;.;#;#;.;#;#;#;#;#;#;.;#;.;#;.;#;.;#;.;.;.;#;#;#;.;#;.;#;#;.;#;.;#;#;#;#;#;.;#;.;#;.;#;#;#;#;#;.;.;.;.;#;.;#;.;#
#;#;#;.;#;.;.;.;#;.;.;.;.;.;#;.;#;.;.;#;.;#;.;.;.;#;.;.;#;.;#;.;.;#;.;#;.;#;.;#;.;#;.;#;.;.;.;#;.;#;.;#;.;.;#;.;.;.;.;.;#;.;#;.;#;.;#;.;.;.;#;.;#;#;#;#;#;#;.;#
#;.;.;.;#;#;#;#;#;.;#;#;#;.;#;.;#;#;.;#;.;#;#;#;#;#;#;.;#;.;#;#;.;#;.;#;.;#;.;#;.;#;.;#;#;#;.;#;.;#;.;#;.;#;#;.;#;.;#;.;#;.;#;.;.;.;#;.;#;.;.;.;.;.;.;.;.;#;.;#
#;.;#;#;#;.;.;.;.;.;.;.;#;.;#;.;#;.;.;.;.;.;.;.;.;.;.;.;#;.;#;.;.;#;.;#;.;#;.;#;.;#;.;.;.;#;.;#;.;#;.;#;.;.;#;.;#;.;#;#;#;#;#;.;#;#;#;#;#;#;#;#;.;#;#;#;#;#;.;#
#;.;.;.;#;#;.;#;#;#;.;#;#;#;#;.;#;#;#;#;#;#;#;#;#;#;#;#;#;.;#;.;#;#;.;#;.;#;.;#;.;#;#;#;.;#;.;#;.;#;.;#;#;.;#;.;#;#;#;.;.;.;.;.;.;#;.;.;.;.;.;#;.;.;.;.;.;.;.;#
#;#;#;.;#;.;.;.;#;.;.;.;.;#;.;.;.;.;.;#;.;#;.;.;.;.;#;.;.;.;#;.;.;.;.;#;.;#;.;#;.;.;.;#;.;#;.;#;.;#;.;#;.;.;#;.;#;.;#;.;#;#;#;#;#;#;.;#;#;#;#;#;#;#;#;#;#;#;.;#
#;.;.;.;#;#;#;.;#;.;#;#;.;#;.;#;.;#;.;#;.;#;#;#;#;.;#;.;#;.;#;.;#;.;#;#;.;#;.;#;#;#;.;#;.;#;.;#;.;#;.;#;.;#;#;.;#;.;#;.;#;.;.;.;.;.;.;.;.;.;.;#;.;.;.;#;.;.;.;#
#;.;#;.;#;.;#;.;#;.;#;.;.;#;.;#;#;#;.;#;.;.;.;.;.;.;.;.;#;.;.;.;#;.;#;.;.;#;.;#;.;#;.;#;.;#;.;.;.;.;.;#;.;.;#;.;.;.;#;.;#;#;.;#;#;#;#;#;.;#;.;#;.;#;.;#;.;#;#;#
#;.;#;.;#;.;#;.;#;.;#;#;.;#;.;.;.;#;#;#;.;#;#;#;#;#;#;#;#;#;#;#;#;.;#;.;#;#;.;#;.;#;.;#;.;#;#;#;#;#;#;#;#;#;#;.;#;.;.;.;#;.;.;#;.;.;.;.;.;#;.;#;.;#;.;.;.;#;.;#
#;.;#;.;#;.;#;.;#;.;.;#;.;#;#;#;.;.;.;.;.;.;.;.;.;.;.;.;.;.;.;.;.;.;#;.;.;#;.;.;.;.;.;#;.;#;.;.;.;.;.;.;.;#;#;#;#;.;#;#;#;.;#;#;#;#;#;.;.;#;.;#;.;#;#;#;#;#;.;#
#;.;.;.;#;.;#;.;#;#;#;#;.;.;.;#;.;#;#;#;#;#;#;#;#;#;#;#;#;#;#;#;#;#;#;#;.;#;#;#;#;#;.;#;.;#;#;#;.;#;#;#;.;#;.;.;.;.;#;.;#;.;#;.;#;.;#;#;#;#;#;#;.;#;.;#;.;.;.;#
#;.;#;.;#;.;.;.;.;.;.;.;.;#;.;#;.;#;.;#;.;.;.;.;.;.;#;.;.;.;#;.;.;.;.;#;.;.;.;.;.;#;.;#;.;.;.;.;.;#;.;#;.;.;.;.;#;#;#;.;#;.;.;.;#;.;.;.;.;.;.;.;.;#;.;.;.;#;.;#
#;.;#;#;#;.;#;#;#;#;#;#;#;#;.;#;.;.;.;#;.;#;.;.;#;.;.;.;#;.;.;.;#;.;#;#;#;#;.;#;.;#;#;#;#;#;#;#;#;#;.;#;#;#;#;.;#;.;.;.;#;.;#;#;#;.;#;#;#;#;#;#;#;#;#;#;.;#;.;#
#;.;.;.;.;.;.;.;.;.;.;.;#;.;.;#;.;#;.;#;.;#;.;#;#;#;#;#;#;.;#;#;#;#;#;.;.;.;.;#;.;#;.;.;.;.;.;.;.;.;.;.;.;.;#;.;#;.;#;.;#;.;.;.;#;.;.;.;.;.;.;.;.;.;.;.;.;#;.;#
#;.;#;#;#;#;#;#;#;#;#;.;#;#;#;#;#;#;.;#;.;#;.;.;.;.;.;.;#;.;.;.;.;.;#;.;.;#;.;#;.;#;.;#;#;#;#;#;#;#;#;#;#;#;#;#;#;.;#;.;#;#;#;.;#;.;#;#;#;#;#;.;#;#;#;.;#;#;.;#
#;.;#;.;.;.;.;.;.;.;#;.;.;.;.;.;.;.;.;#;.;#;.;#;#;#;#;#;#;#;#;#;#;#;#;.;#;#;#;#;.;.;.;.;.;.;.;.;.;.;.;.;.;.;.;.;.;.;#;.;#;.;.;.;#;.;#;.;.;.;.;.;.;.;#;.;.;.;.;#
#;.;#;#;#;#;#;#;#;.;#;#;#;#;#;#;#;#;#;#;#;#;.;#;.;.;.;.;.;.;.;.;.;.;.;.;.;.;.;#;#;#;#;#;#;#;#;#;#;#;#;#;#;#;#;#;#;#;#;#;#;.;#;#;#;.;#;#;#;#;#;#;#;#;#;#;#;#;#;#
#;.;#;.;.;.;.;#;.;.;.;.;.;.;.;#;.;.;.;.;.;#;.;#;#;#;.;#;#;#;#;#;#;#;#;#;#;#;#;#;.;.;.;.;.;.;.;.;.;.;.;.;.;.;.;.;.;.;.;#;.;.;.;.;#;.;.;#;.;.;.;#;.;.;.;#;.;.;.;#
#;.;#;.;#;#;.;#;.;#;#;#;#;.;#;#;#;#;.;#;.;.;.;#;.;#;.;#;.;.;.;.;#;.;.;.;#;.;.;.;.;#;#;#;#;#;.;#;#;#;.;#;#;#;#;#;#;#;#;#;.;#;#;#;#;#;.;#;.;#;.;.;.;#;.;.;.;#;.;#
#;.;.;.;#;.;.;.;.;#;.;.;.;.;.;.;.;#;.;#;#;#;#;#;.;#;.;#;.;#;#;#;#;#;.;#;#;.;#;#;.;#;.;.;.;#;.;.;.;#;.;#;.;.;.;.;.;.;.;#;.;#;.;#;.;#;.;#;#;#;#;#;#;#;#;#;.;#;.;#
#;#;#;#;#;#;#;#;#;#;#;#;#;#;#;#;.;#;.;.;.;.;.;.;.;#;.;.;.;.;.;.;#;.;.;.;.;.;.;#;.;#;.;#;#;#;.;#;.;#;.;#;#;#;#;#;.;#;.;#;.;#;.;#;.;#;.;.;.;.;.;.;.;.;.;#;#;#;.;#
#;.;#;.;.;.;.;.;.;.;.;#;.;.;.;#;.;#;.;#;#;#;#;#;#;#;#;.;#;#;.;#;#;.;#;#;#;#;.;#;.;#;.;.;.;#;.;#;#;#;.;#;.;.;.;.;.;#;.;#;.;#;.;#;.;#;#;#;#;#;.;#;#;#;.;.;.;.;.;#
#;.;#;#;#;#;#;#;.;#;.;.;.;#;.;#;.;#;.;#;.;#;.;.;.;#;.;.;#;.;.;#;.;.;.;.;.;.;.;#;#;#;#;#;.;.;.;.;.;#;.;#;#;#;.;#;#;#;.;#;.;#;.;.;.;.;.;.;.;#;.;.;.;#;#;#;#;#;#;#
#;.;.;.;.;.;.;#;.;#;#;#;#;#;#;#;.;#;.;#;.;#;.;#;.;.;.;.;#;.;#;#;#;.;#;.;#;#;#;#;.;.;.;.;.;#;.;#;.;.;.;#;.;.;.;.;.;#;.;#;.;#;#;.;#;#;#;#;#;#;#;#;.;.;.;#;.;.;.;#
#;#;.;#;.;#;.;#;.;#;.;.;.;.;.;.;.;#;.;#;.;#;#;#;#;#;#;.;#;.;.;.;.;.;.;.;.;.;.;#;#;#;#;#;#;#;#;#;#;#;#;#;.;#;#;#;#;#;.;#;.;.;.;.;.;.;.;.;.;.;.;#;.;#;.;#;#;#;.;#
#;.;.;#;.;#;#;#;.;#;#;#;#;#;#;#;.;#;.;#;.;#;.;.;.;#;.;.;#;.;#;#;#;#;#;#;#;#;.;#;.;.;.;.;.;.;.;.;.;.;.;.;.;#;.;.;.;#;.;#;#;#;#;#;#;#;#;#;#;#;.;#;.;#;.;#;.;#;.;#
#;.;#;#;.;#;.;.;.;#;.;#;.;.;.;.;.;#;.;#;.;.;.;#;.;.;.;.;#;.;#;.;.;#;.;.;.;#;.;#;.;#;.;#;#;#;.;#;#;#;#;#;#;#;.;#;.;#;.;.;.;.;.;.;.;.;.;.;.;.;.;#;.;#;.;.;.;.;.;#
#;.;#;.;.;#;.;#;#;#;.;#;.;#;#;#;#;#;.;#;#;#;#;#;.;#;#;#;#;.;#;.;#;#;.;#;.;#;.;#;.;#;.;#;.;#;.;#;.;.;.;.;.;.;.;#;.;#;#;#;#;#;#;#;#;#;#;#;#;#;#;#;.;#;#;#;#;#;#;#
#;.;#;.;#;#;.;#;.;.;.;#;.;#;.;.;.;.;.;#;.;#;.;#;.;.;.;.;.;.;.;.;.;#;.;#;#;#;.;#;.;#;#;#;.;#;.;#;#;#;.;#;#;#;#;#;.;#;.;.;.;.;.;.;.;.;.;.;.;#;.;#;.;.;#;.;#;.;.;#
#;.;#;.;.;#;.;.;.;#;.;#;.;#;#;#;#;#;.;#;.;.;.;#;#;#;#;#;#;#;#;#;#;#;.;.;.;.;.;#;.;.;.;.;.;#;.;.;.;#;.;#;.;.;.;.;.;#;.;#;#;#;.;#;#;#;#;#;.;#;.;#;#;.;#;.;#;#;.;#
#;.;#;#;.;#;.;#;.;.;.;#;.;#;.;.;.;.;.;.;.;#;#;#;.;.;.;.;.;.;.;.;.;.;.;#;#;#;#;#;.;#;#;#;#;#;#;.;#;#;.;#;.;#;#;#;#;#;.;#;.;#;.;.;.;.;.;#;.;#;.;#;.;.;#;.;.;#;.;#
#;.;#;.;.;#;.;#;#;#;#;#;.;#;.;#;#;#;#;#;#;#;.;#;#;#;#;.;#;#;#;#;#;#;.;.;.;.;.;.;.;.;.;.;.;#;.;.;.;#;.;#;.;#;.;.;.;#;.;#;.;#;.;#;#;#;.;#;.;#;.;#;.;#;#;.;.;.;.;#
#;.;#;.;.;.;.;.;.;#;.;.;.;.;.;.;.;.;.;#;.;.;.;.;.;.;#;.;#;.;.;.;.;#;#;#;#;#;#;#;.;#;#;#;.;#;.;#;.;#;.;#;.;#;.;#;.;#;.;#;.;#;.;#;.;.;.;#;.;#;.;.;.;.;#;.;#;.;.;#
#;.;#;#;#;.;#;#;#;#;.;#;.;#;#;#;#;#;#;#;.;#;#;#;#;#;#;.;#;#;#;#;.;#;.;.;.;#;.;#;.;#;.;#;#;#;.;#;.;#;.;#;.;#;.;#;.;#;.;#;.;#;.;#;#;#;.;#;.;#;#;#;.;#;#;.;#;.;#;#
#;.;.;.;.;.;.;.;.;.;.;#;.;.;.;.;.;.;.;.;.;.;.;.;.;.;#;.;.;.;.;.;.;.;.;#;.;.;.;.;.;.;.;.;.;.;.;#;.;.;.;.;.;.;.;#;.;.;.;#;.;.;.;.;.;#;.;#;.;.;.;.;.;.;.;.;#;.;.;#
#;#;#;#;#;#;#;#;#;#;#;#;#;#;#;#;#;#;#;#;#;#;#;#;#;#;#;#;#;#;#;#;#;#;#;#;#;#;#;#;#;#;#;#;#;#;#;#;#;#;#;#;#;#;#;#;#;#;#;#;#;#;#;#;#;#;#;#;#;#;#;#;#;#;#;#;#;#;#;#